5000,J,1
10000,C,1
15000,M,1
20000,N,1
25000,J,0
30000,C,0
35000,M,0
40000,N,0
45000,J,2
50000,C,2
55000,M,2
60000,N,2
65000,J,1
70000,C,1
75000,M,1
80000,N,1
85000,J,1
90000,C,1
95000,M,1
100000,N,1
